10 10
..TXS.....
...X...XXX
..X...X..K
..XXX..GXX
.....X....
..XK.X....
..GXXX....
..X....XXX
..X....X.K
..G.......