10 10
......G...
..XXX.....
XT.GX...XX
XXX......X
....X....X
XXK.XXX...
..XXXXX...
XX...XX.K.
........G.
XX..SXX...